        cyberready.world
                           .-.
                          {{#}}
          {}               8@8
        .::::.             888
    @\\/W\/\/W\//@         8@8
     \\/^\/\/^\//     _    )8(    _
      \_O_{}_O_/     (@)__/8@8\__(@)
 ____________________ `~"-=):(=-"~`
|<><><>  |  |  <><><>|     |.|
|<>      |  |      <>|     |C|
|<>      |  |      <>|     |'|
|<>   .--------.   <>|     |.|
|     |   ()   |     |     |Y|
|_____| (O\/O) |_____|     |'|
|     \   /\   /     |     |.|
|------\  \/  /------|     |B|
|       '.__.'       |     |'|
|        |  |        |     |.|
:        |  |        :     |E|
 \       |  |       /      |'|
  \<>    |  |    <>/       |.|
   \<>   |  |   <>/        |R|
    `\<> |  | <>/'         |'|
      `-.|__|.-`           \ /
                            ^
        CyberReady                      